10
# # # # # # # # # #
. . # . # . . . . #
# . # . . . # # # #
# . # . # . # . # #
# . # . # . # . # #
# . # . # . # . # #
# . . . # . . . . @
# . # . # . # . # #
# . # . # . # . # #
# # # # # # # # # #
